25
50
177 177 177 177 177 177 177 177 177 177 177 177 177 177 177 177 177 177 177 177 177 177 177 177 177 177 177 177 177 177 177 177 177 177 177 177 177 177 177 177 177 177 177 177 177 177 177 177 177 177 
177 177 177 32 32 32 32 32 32 32 32 32 177 177 177 177 177 177 177 177 32 32 32 32 32 32 32 32 32 32 177 177 177 177 177 177 177 177 32 32 32 32 32 32 32 32 32 177 177 177 
177 177 177 32 32 177 177 32 32 177 32 32 177 177 177 177 32 32 32 32 32 32 177 177 177 177 177 177 32 32 32 32 32 32 177 177 177 177 32 32 177 32 32 177 177 32 32 177 177 177 
177 32 32 32 32 177 177 32 32 177 32 32 177 177 177 177 32 32 177 177 177 177 177 177 177 177 177 177 177 177 177 177 32 32 177 177 177 177 32 32 177 32 32 177 177 32 32 32 32 177 
177 32 32 177 177 177 177 32 32 177 32 32 32 32 32 32 32 32 177 177 177 177 177 177 177 177 177 177 177 177 177 177 32 32 32 32 32 32 32 32 177 32 32 177 177 177 177 32 32 177 
177 32 32 177 177 177 177 32 32 177 177 177 32 32 177 177 32 32 32 32 177 177 32 32 32 32 32 32 177 177 32 32 32 32 177 177 32 32 177 177 177 32 32 177 177 177 177 32 32 177 
177 32 32 32 32 177 177 32 32 32 32 32 32 32 32 32 177 177 32 32 32 32 32 32 177 177 32 32 32 32 32 32 177 177 32 32 32 32 32 32 32 32 32 177 177 32 32 32 32 177 
177 177 32 32 32 32 32 177 177 177 177 177 177 177 32 32 177 177 177 177 177 177 32 32 177 177 32 32 177 177 177 177 177 177 32 32 177 177 177 177 177 177 177 32 32 32 32 32 177 177 
177 177 32 32 177 32 32 32 32 177 177 177 177 177 32 32 177 177 177 177 177 177 32 32 177 177 32 32 177 177 177 177 177 177 32 32 177 177 177 177 177 32 32 32 32 177 32 32 177 177 
177 177 32 32 177 177 177 32 32 32 32 32 32 32 32 32 177 177 177 177 32 32 32 32 177 177 32 32 32 32 177 177 177 177 32 32 32 32 32 32 32 32 32 177 177 177 32 32 177 177 
177 177 32 32 177 177 177 177 177 32 32 177 177 177 32 32 32 32 32 32 32 32 177 177 177 177 177 177 32 32 32 32 32 32 32 32 177 177 177 32 32 177 177 177 177 177 32 32 177 177 
177 177 177 32 32 177 177 177 177 32 32 177 177 32 32 177 177 177 177 177 32 32 32 32 32 32 32 32 32 32 177 177 177 177 177 32 32 177 177 32 32 177 177 177 177 32 32 177 177 177 
177 177 177 177 32 32 32 32 32 32 32 32 32 32 177 177 177 177 177 177 177 177 177 32 32 32 32 177 177 177 177 177 177 177 177 177 32 32 32 32 32 32 32 32 32 32 177 177 177 177 
177 177 177 32 32 177 177 177 177 32 32 177 177 32 32 177 177 177 177 177 32 32 32 32 32 32 32 32 32 32 177 177 177 177 177 32 32 177 177 32 32 177 177 177 177 32 32 177 177 177 
177 177 32 32 177 177 177 177 177 32 32 177 177 177 32 32 32 32 32 32 32 32 177 177 177 177 177 177 32 32 32 32 32 32 32 32 177 177 177 32 32 177 177 177 177 177 32 32 177 177 
177 177 32 32 177 177 177 32 32 32 32 32 32 32 32 32 177 177 177 177 32 32 32 32 177 177 32 32 32 32 177 177 177 177 32 32 32 32 32 32 32 32 32 177 177 177 32 32 177 177 
177 177 32 32 177 32 32 32 32 177 177 177 177 177 32 32 177 177 177 177 177 177 32 32 177 177 32 32 177 177 177 177 177 177 32 32 177 177 177 177 177 32 32 32 32 177 32 32 177 177 
177 177 32 32 32 32 32 177 177 177 177 177 177 177 32 32 177 177 177 177 177 177 32 32 177 177 32 32 177 177 177 177 177 177 32 32 177 177 177 177 177 177 177 32 32 32 32 32 177 177 
177 32 32 32 32 177 177 32 32 32 32 32 32 32 32 32 177 177 32 32 32 32 32 32 177 177 32 32 32 32 32 32 177 177 32 32 32 32 32 32 32 32 32 177 177 32 32 32 32 177 
177 32 32 177 177 177 177 32 32 177 177 177 32 32 177 177 32 32 32 32 177 177 32 32 32 32 32 32 177 177 32 32 32 32 177 177 32 32 177 177 177 32 32 177 177 177 177 32 32 177 
177 32 32 177 177 177 177 32 32 177 32 32 32 32 32 32 32 32 177 177 177 177 177 177 177 177 177 177 177 177 177 177 32 32 32 32 32 32 32 32 177 32 32 177 177 177 177 32 32 177 
177 32 32 32 32 177 177 32 32 177 32 32 177 177 177 177 32 32 177 177 177 177 177 177 177 177 177 177 177 177 177 177 32 32 177 177 177 177 32 32 177 32 32 177 177 32 32 32 32 177 
177 177 177 32 32 177 177 32 32 177 32 32 177 177 177 177 32 32 32 32 32 32 177 177 177 177 177 177 32 32 32 32 32 32 177 177 177 177 32 32 177 32 32 177 177 32 32 177 177 177 
177 177 177 32 32 32 32 32 32 32 32 32 177 177 177 177 177 177 177 177 32 32 32 32 32 32 32 32 32 32 177 177 177 177 177 177 177 177 32 32 32 32 32 32 32 32 32 177 177 177 
177 177 177 177 177 177 177 177 177 177 177 177 177 177 177 177 177 177 177 177 177 177 177 177 177 177 177 177 177 177 177 177 177 177 177 177 177 177 177 177 177 177 177 177 177 177 177 177 177 177 